00010000000000001000
00000101100110100000
11111100000000111111
00000101100110100000
00010000000000001000
