a001000000000000100b
00000101100110100000
11111100000000111111
00000101100110100000
c001000000000000100d
